-100 -100 -100 -100 -100 -100 -100 -100 -100
-100 1 100 0 0 1 0 0 -100
-100 0 0 0 1 1 100 0 -100
-100 0 0 1 100 0 1 0 -100
-100 0 100 0 0 0 0 0 -100
-100 -100 -100 -100 -100 -100 -100 -100 -100
